LVL 0 0 64 64
-1 -1 -1 -1 -1 -1 -1 -1 -1 -1 -1 -1 -1 -1 -1 -1 -1 -1 -1 -1 -1 -1 -1 -1 -1 -1 -1 -1
-1 -1 -1 -1 -1 -1 -1 -1 -1 -1 -1 -1 -1 -1 -1 -1 -1 -1 -1 -1 -1 -1 -1 -1 -1 -1 -1 -1
-1 -1 -1 -1 -1 -1 -1 -1 -1 -1 -1 -1 -1 -1 -1 -1 -1 -1 -1 -1 -1 -1 -1 -1 -1 -1 -1 -1
-1 -1 -1 -1 -1 -1 -1 -1 -1 -1 -1 -1 -1 -1 -1 -1 -1 -1 -1 -1 -1 -1 -1 -1 -1 -1 -1 -1
-1 -1 -1 -1 02 02 02 07 02 02 02 02 02 02 02 02 02 02 02 02 02 02 02 02 -1 -1 -1 -1
-1 -1 -1 -1 06 06 06 06 06 06 06 06 06 06 06 06 06 06 06 06 06 06 06 06 -1 -1 -1 -1
-1 -1 -1 -1 06 06 06 06 06 06 06 06 06 06 06 06 06 06 06 06 06 06 06 06 -1 -1 -1 -1
-1 -1 -1 -1 06 06 06 06 06 06 06 06 06 06 06 06 06 06 06 06 06 06 06 06 -1 -1 -1 -1
-1 -1 -1 -1 01 01 01 01 01 01 01 01 01 01 01 01 01 01 01 01 01 06 06 06 -1 -1 -1 -1
-1 -1 -1 -1 03 03 03 03 03 03 03 03 03 03 03 03 03 03 03 03 10 06 06 06 -1 -1 -1 -1
-1 -1 -1 -1 02 02 02 03 02 02 02 02 02 02 02 02 02 02 02 02 02 06 06 06 -1 -1 -1 -1
-1 -1 -1 -1 06 06 06 09 06 06 06 06 06 06 06 06 06 06 06 06 06 06 06 06 -1 -1 -1 -1
-1 -1 -1 -1 06 06 06 08 06 06 06 06 06 06 06 06 06 06 06 06 06 06 06 06 -1 -1 -1 -1
-1 -1 -1 -1 06 06 06 08 06 06 06 06 06 06 06 06 06 06 06 06 06 06 06 06 -1 -1 -1 -1
-1 -1 -1 -1 01 01 01 01 01 01 01 01 01 01 01 01 01 01 01 01 01 06 06 06 -1 -1 -1 -1
-1 -1 -1 -1 -1 -1 -1 -1 -1 -1 -1 -1 -1 -1 -1 -1 -1 -1 -1 -1 01 06 06 06 -1 -1 -1 -1
-1 -1 -1 -1 -1 -1 -1 -1 -1 -1 -1 -1 -1 -1 -1 -1 -1 -1 -1 -1 01 06 06 06 -1 -1 -1 -1
-1 -1 -1 -1 -1 -1 -1 -1 -1 -1 -1 -1 -1 -1 -1 -1 -1 -1 -1 -1 01 06 06 06 -1 -1 -1 -1
-1 -1 -1 -1 -1 -1 -1 -1 -1 -1 -1 -1 -1 -1 -1 -1 -1 -1 -1 -1 -1 06 06 06 -1 -1 -1 -1
-1 -1 -1 -1 -1 -1 -1 -1 -1 -1 -1 -1 -1 -1 -1 -1 -1 -1 -1 -1 -1 01 -1 -1 -1 -1 -1 -1